w,w,w,w,w,w,w,w,
w,.,b10,.,.,.,21,w,
w,.,o,.,b,.,.,w,
w,.,o,.,.,.,.,w,
w,.,.,s,.,.,.,w,
w,.,b,.,p,.,.,w,
w,.,.,12,.,.,.,w,
w,w,w,w,w,w,w,w,