##########
#        #
#  PB  P #
#  BB    #
#  TP    #
#        #
##########
